"filename", "language", "JSON", "JavaScript", "JSON with Comments", "TypeScript", "comment", "blank", "total"
"d:\PZB\Cocos3D\HelloTK3.4.0\.vs\HelloTK\project-colors.json", "JSON", 11, 0, 0, 0, 0, 0, 11
"d:\PZB\Cocos3D\HelloTK3.4.0\.vs\VSWorkspaceState.json", "JSON", 16, 0, 0, 0, 0, 0, 16
"d:\PZB\Cocos3D\HelloTK3.4.0\assets\Script\BattleField\Attack\AtkMgr.ts", "TypeScript", 0, 0, 0, 60, 9, 13, 82
"d:\PZB\Cocos3D\HelloTK3.4.0\assets\Script\BattleField\Attack\DmgCal.ts", "TypeScript", 0, 0, 0, 32, 12, 12, 56
"d:\PZB\Cocos3D\HelloTK3.4.0\assets\Script\BattleField\Attack\Info.ts", "TypeScript", 0, 0, 0, 27, 0, 11, 38
"d:\PZB\Cocos3D\HelloTK3.4.0\assets\Script\BattleField\BattleFieldMaker.ts", "TypeScript", 0, 0, 0, 66, 0, 11, 77
"d:\PZB\Cocos3D\HelloTK3.4.0\assets\Script\BattleField\BattlePage.ts", "TypeScript", 0, 0, 0, 67, 4, 8, 79
"d:\PZB\Cocos3D\HelloTK3.4.0\assets\Script\BattleField\BattlePauseMenu.ts", "TypeScript", 0, 0, 0, 18, 0, 3, 21
"d:\PZB\Cocos3D\HelloTK3.4.0\assets\Script\BattleField\BattleResult.ts", "TypeScript", 0, 0, 0, 80, 1, 8, 89
"d:\PZB\Cocos3D\HelloTK3.4.0\assets\Script\BattleField\BattleScene.ts", "TypeScript", 0, 0, 0, 27, 1, 5, 33
"d:\PZB\Cocos3D\HelloTK3.4.0\assets\Script\BattleField\HP\HpMgr.ts", "TypeScript", 0, 0, 0, 71, 1, 12, 84
"d:\PZB\Cocos3D\HelloTK3.4.0\assets\Script\BattleField\HP\HpNum.ts", "TypeScript", 0, 0, 0, 33, 2, 6, 41
"d:\PZB\Cocos3D\HelloTK3.4.0\assets\Script\BattleField\Monster\MonsterMgr.ts", "TypeScript", 0, 0, 0, 33, 0, 6, 39
"d:\PZB\Cocos3D\HelloTK3.4.0\assets\Script\Error\BasicException.ts", "TypeScript", 0, 0, 0, 60, 4, 13, 77
"d:\PZB\Cocos3D\HelloTK3.4.0\assets\Script\Error\UserException.ts", "TypeScript", 0, 0, 0, 7, 19, 7, 33
"d:\PZB\Cocos3D\HelloTK3.4.0\assets\Script\Heros\Formation\Formation.ts", "TypeScript", 0, 0, 0, 202, 4, 23, 229
"d:\PZB\Cocos3D\HelloTK3.4.0\assets\Script\Heros\Formation\FormationBar.ts", "TypeScript", 0, 0, 0, 40, 0, 6, 46
"d:\PZB\Cocos3D\HelloTK3.4.0\assets\Script\Heros\Formation\HeroPortrait.ts", "TypeScript", 0, 0, 0, 64, 0, 8, 72
"d:\PZB\Cocos3D\HelloTK3.4.0\assets\Script\Heros\HerosMgr.ts", "TypeScript", 0, 0, 0, 173, 6, 12, 191
"d:\PZB\Cocos3D\HelloTK3.4.0\assets\Script\Items\Item.ts", "TypeScript", 0, 0, 0, 54, 1, 10, 65
"d:\PZB\Cocos3D\HelloTK3.4.0\assets\Script\Items\ItemBrowser.ts", "TypeScript", 0, 0, 0, 158, 0, 18, 176
"d:\PZB\Cocos3D\HelloTK3.4.0\assets\Script\Items\ItemMgr.ts", "TypeScript", 0, 0, 0, 54, 4, 9, 67
"d:\PZB\Cocos3D\HelloTK3.4.0\assets\Script\NetWork\Json2Exc.ts", "TypeScript", 0, 0, 0, 8, 37, 11, 56
"d:\PZB\Cocos3D\HelloTK3.4.0\assets\Script\NetWork\LoginMsg.ts", "TypeScript", 0, 0, 0, 38, 17, 7, 62
"d:\PZB\Cocos3D\HelloTK3.4.0\assets\Script\NetWork\MD5.ts", "TypeScript", 0, 0, 0, 208, 0, 2, 210
"d:\PZB\Cocos3D\HelloTK3.4.0\assets\Script\NetWork\NetWork.ts", "TypeScript", 0, 0, 0, 48, 3, 8, 59
"d:\PZB\Cocos3D\HelloTK3.4.0\assets\Script\Player\PlayerMgr.ts", "TypeScript", 0, 0, 0, 85, 9, 17, 111
"d:\PZB\Cocos3D\HelloTK3.4.0\assets\Script\Spirit\SpiritMgr.ts", "TypeScript", 0, 0, 0, 7, 30, 7, 44
"d:\PZB\Cocos3D\HelloTK3.4.0\assets\Script\StartScene\Loading.ts", "TypeScript", 0, 0, 0, 151, 2, 7, 160
"d:\PZB\Cocos3D\HelloTK3.4.0\assets\Script\StartScene\SignUp.ts", "TypeScript", 0, 0, 0, 44, 2, 8, 54
"d:\PZB\Cocos3D\HelloTK3.4.0\assets\Script\StartScene\StartPage.ts", "TypeScript", 0, 0, 0, 175, 2, 8, 185
"d:\PZB\Cocos3D\HelloTK3.4.0\assets\Script\StartScene\StartScene.ts", "TypeScript", 0, 0, 0, 24, 0, 3, 27
"d:\PZB\Cocos3D\HelloTK3.4.0\assets\Script\Tools\AlertLbl.ts", "TypeScript", 0, 0, 0, 26, 0, 6, 32
"d:\PZB\Cocos3D\HelloTK3.4.0\assets\Script\Tools\Configure.ts", "TypeScript", 0, 0, 0, 36, 0, 5, 41
"d:\PZB\Cocos3D\HelloTK3.4.0\assets\Script\Tools\Err.ts", "TypeScript", 0, 0, 0, 26, 2, 7, 35
"d:\PZB\Cocos3D\HelloTK3.4.0\assets\Script\Tools\Functions.ts", "TypeScript", 0, 0, 0, 206, 22, 24, 252
"d:\PZB\Cocos3D\HelloTK3.4.0\assets\Script\Tools\GameMgr.ts", "TypeScript", 0, 0, 0, 32, 2, 4, 38
"d:\PZB\Cocos3D\HelloTK3.4.0\assets\Script\Tools\Generator.ts", "TypeScript", 0, 0, 0, 40, 0, 7, 47
"d:\PZB\Cocos3D\HelloTK3.4.0\assets\Script\Tools\ImgMgr.ts", "TypeScript", 0, 0, 0, 26, 0, 6, 32
"d:\PZB\Cocos3D\HelloTK3.4.0\assets\Script\Tools\MoveCamera.ts", "TypeScript", 0, 0, 0, 122, 1, 15, 138
"d:\PZB\Cocos3D\HelloTK3.4.0\assets\Script\Tools\RenderModel2UI.ts", "TypeScript", 0, 0, 0, 24, 0, 7, 31
"d:\PZB\Cocos3D\HelloTK3.4.0\assets\Script\Tools\ResMgr.ts", "TypeScript", 0, 0, 0, 48, 1, 8, 57
"d:\PZB\Cocos3D\HelloTK3.4.0\assets\Script\Tools\SceneMgr.ts", "TypeScript", 0, 0, 0, 53, 1, 10, 64
"d:\PZB\Cocos3D\HelloTK3.4.0\assets\Script\Tools\ShowNum.ts", "TypeScript", 0, 0, 0, 46, 12, 14, 72
"d:\PZB\Cocos3D\HelloTK3.4.0\assets\Script\Tools\Subscribe.ts", "TypeScript", 0, 0, 0, 37, 12, 6, 55
"d:\PZB\Cocos3D\HelloTK3.4.0\assets\Script\Tools\TouchScreen.ts", "TypeScript", 0, 0, 0, 34, 1, 6, 41
"d:\PZB\Cocos3D\HelloTK3.4.0\assets\Script\UI\MainScene\HeroList\HeroEquip.ts", "TypeScript", 0, 0, 0, 7, 0, 2, 9
"d:\PZB\Cocos3D\HelloTK3.4.0\assets\Script\UI\MainScene\HeroList\HeroInfo.ts", "TypeScript", 0, 0, 0, 20, 4, 4, 28
"d:\PZB\Cocos3D\HelloTK3.4.0\assets\Script\UI\MainScene\HeroList\HeroList.ts", "TypeScript", 0, 0, 0, 74, 4, 17, 95
"d:\PZB\Cocos3D\HelloTK3.4.0\assets\Script\UI\MainScene\HeroList\HeroListEquip.ts", "TypeScript", 0, 0, 0, 7, 30, 8, 45
"d:\PZB\Cocos3D\HelloTK3.4.0\assets\Script\UI\MainScene\HeroList\HeroListPortrait.ts", "TypeScript", 0, 0, 0, 30, 0, 7, 37
"d:\PZB\Cocos3D\HelloTK3.4.0\assets\Script\UI\MainScene\HeroList\HeroSpirit.ts", "TypeScript", 0, 0, 0, 7, 0, 2, 9
"d:\PZB\Cocos3D\HelloTK3.4.0\assets\Script\UI\MainScene\HeroList\Model_UI.ts", "TypeScript", 0, 0, 0, 42, 0, 8, 50
"d:\PZB\Cocos3D\HelloTK3.4.0\assets\Script\UI\MainScene\Inventory\Inventory.ts", "TypeScript", 0, 0, 0, 69, 0, 13, 82
"d:\PZB\Cocos3D\HelloTK3.4.0\assets\Script\UI\MainScene\Inventory\InventoryMgr.ts", "TypeScript", 0, 0, 0, 85, 4, 10, 99
"d:\PZB\Cocos3D\HelloTK3.4.0\assets\Script\UI\MainScene\League\DynamicList.ts", "TypeScript", 0, 0, 0, 101, 0, 13, 114
"d:\PZB\Cocos3D\HelloTK3.4.0\assets\Script\UI\MainScene\League\League.ts", "TypeScript", 0, 0, 0, 25, 0, 5, 30
"d:\PZB\Cocos3D\HelloTK3.4.0\assets\Script\UI\MainScene\League\LeagueInfo.ts", "TypeScript", 0, 0, 0, 102, 3, 16, 121
"d:\PZB\Cocos3D\HelloTK3.4.0\assets\Script\UI\MainScene\League\LeagueJoin.ts", "TypeScript", 0, 0, 0, 57, 0, 7, 64
"d:\PZB\Cocos3D\HelloTK3.4.0\assets\Script\UI\MainScene\League\LeagueList.ts", "TypeScript", 0, 0, 0, 53, 0, 6, 59
"d:\PZB\Cocos3D\HelloTK3.4.0\assets\Script\UI\MainScene\League\LeagueMgr.ts", "TypeScript", 0, 0, 0, 404, 14, 17, 435
"d:\PZB\Cocos3D\HelloTK3.4.0\assets\Script\UI\MainScene\Mail\Mail.ts", "TypeScript", 0, 0, 0, 103, 3, 18, 124
"d:\PZB\Cocos3D\HelloTK3.4.0\assets\Script\UI\MainScene\Mail\MailMgr.ts", "TypeScript", 0, 0, 0, 90, 10, 15, 115
"d:\PZB\Cocos3D\HelloTK3.4.0\assets\Script\UI\MainScene\Mail\MailTitle.ts", "TypeScript", 0, 0, 0, 27, 0, 4, 31
"d:\PZB\Cocos3D\HelloTK3.4.0\assets\Script\UI\MainScene\MainPage.ts", "TypeScript", 0, 0, 0, 32, 0, 4, 36
"d:\PZB\Cocos3D\HelloTK3.4.0\assets\Script\UI\MainScene\MainScene.ts", "TypeScript", 0, 0, 0, 25, 2, 5, 32
"d:\PZB\Cocos3D\HelloTK3.4.0\assets\Script\UI\MainScene\TaskList\Task.ts", "TypeScript", 0, 0, 0, 6, 0, 2, 8
"d:\PZB\Cocos3D\HelloTK3.4.0\assets\Script\UI\MainScene\TaskList\TaskList.ts", "TypeScript", 0, 0, 0, 19, 1, 6, 26
"d:\PZB\Cocos3D\HelloTK3.4.0\assets\Script\UI\MainScene\TaskList\TaskMgr.ts", "TypeScript", 0, 0, 0, 71, 7, 12, 90
"d:\PZB\Cocos3D\HelloTK3.4.0\assets\Script\UI\StageScene\StageDetails.ts", "TypeScript", 0, 0, 0, 82, 0, 9, 91
"d:\PZB\Cocos3D\HelloTK3.4.0\assets\Script\UI\StageScene\StageMaker.ts", "TypeScript", 0, 0, 0, 36, 8, 7, 51
"d:\PZB\Cocos3D\HelloTK3.4.0\assets\Script\UI\StageScene\StageMgr.ts", "TypeScript", 0, 0, 0, 35, 2, 9, 46
"d:\PZB\Cocos3D\HelloTK3.4.0\assets\Script\UI\StageScene\StagePage.ts", "TypeScript", 0, 0, 0, 91, 0, 11, 102
"d:\PZB\Cocos3D\HelloTK3.4.0\assets\Script\UI\StageScene\StagePoint.ts", "TypeScript", 0, 0, 0, 102, 0, 6, 108
"d:\PZB\Cocos3D\HelloTK3.4.0\assets\Script\UI\StageScene\StageScene.ts", "TypeScript", 0, 0, 0, 13, 0, 2, 15
"d:\PZB\Cocos3D\HelloTK3.4.0\assets\Script\UI\UIBase.ts", "TypeScript", 0, 0, 0, 49, 6, 15, 70
"d:\PZB\Cocos3D\HelloTK3.4.0\assets\Script\UI\UIContainer.ts", "TypeScript", 0, 0, 0, 61, 5, 8, 74
"d:\PZB\Cocos3D\HelloTK3.4.0\assets\Script\UI\UIMgr.ts", "TypeScript", 0, 0, 0, 161, 1, 13, 175
"d:\PZB\Cocos3D\HelloTK3.4.0\assets\resources\config\alert.json", "JSON", 39, 0, 0, 0, 0, 0, 39
"d:\PZB\Cocos3D\HelloTK3.4.0\assets\resources\config\base.json", "JSON", 38, 0, 0, 0, 0, 0, 38
"d:\PZB\Cocos3D\HelloTK3.4.0\assets\resources\config\bundle_list.json", "JSON", 3, 0, 0, 0, 0, 0, 3
"d:\PZB\Cocos3D\HelloTK3.4.0\assets\resources\config\hero.json", "JSON", 199, 0, 0, 0, 0, 0, 199
"d:\PZB\Cocos3D\HelloTK3.4.0\assets\resources\config\items.json", "JSON", 74, 0, 0, 0, 0, 0, 74
"d:\PZB\Cocos3D\HelloTK3.4.0\assets\resources\config\monsters.json", "JSON", 89, 0, 0, 0, 0, 0, 89
"d:\PZB\Cocos3D\HelloTK3.4.0\assets\resources\config\soldier.json", "JSON", 207, 0, 0, 0, 0, 0, 207
"d:\PZB\Cocos3D\HelloTK3.4.0\assets\resources\config\stage.json", "JSON", 264, 0, 0, 0, 0, 0, 264
"d:\PZB\Cocos3D\HelloTK3.4.0\assets\resources\config\start_scene.json", "JSON", 27, 0, 0, 0, 0, 0, 27
"d:\PZB\Cocos3D\HelloTK3.4.0\assets\resources\config\task.json", "JSON", 79, 0, 0, 0, 0, 0, 79
"d:\PZB\Cocos3D\HelloTK3.4.0\assets\resources\config\texture.json", "JSON", 77, 0, 0, 0, 0, 0, 77
"d:\PZB\Cocos3D\HelloTK3.4.0\assets\resources\config\ui.json", "JSON", 20, 0, 0, 0, 0, 0, 20
"d:\PZB\Cocos3D\HelloTK3.4.0\bulid\HelloTK\application.8a6fe.js", "JavaScript", 0, 183, 0, 0, 2, 25, 210
"d:\PZB\Cocos3D\HelloTK3.4.0\bulid\HelloTK\assets\start-scene\config.9e21e.json", "JSON", 1, 0, 0, 0, 0, 0, 1
"d:\PZB\Cocos3D\HelloTK3.4.0\bulid\HelloTK\assets\start-scene\import\02\0248a9e15.62a1a.json", "JSON", 1, 0, 0, 0, 0, 1, 2
"d:\PZB\Cocos3D\HelloTK3.4.0\bulid\HelloTK\assets\start-scene\index.9e21e.js", "JavaScript", 0, 60, 0, 0, 1, 46, 107
"d:\PZB\Cocos3D\HelloTK3.4.0\bulid\HelloTK\cocos-js\_commonjsHelpers-19d0a8b5.js", "JavaScript", 0, 1, 0, 0, 0, 1, 2
"d:\PZB\Cocos3D\HelloTK3.4.0\bulid\HelloTK\cocos-js\array-collision-matrix-ec6af177.js", "JavaScript", 0, 1, 0, 0, 0, 1, 2
"d:\PZB\Cocos3D\HelloTK3.4.0\bulid\HelloTK\cocos-js\cc.js", "JavaScript", 0, 109, 0, 0, 0, 35, 144
"d:\PZB\Cocos3D\HelloTK3.4.0\bulid\HelloTK\cocos-js\collision-matrix-28b2cee7.js", "JavaScript", 0, 1, 0, 0, 0, 1, 2
"d:\PZB\Cocos3D\HelloTK3.4.0\bulid\HelloTK\cocos-js\index-bdb8067d.js", "JavaScript", 0, 1, 0, 0, 0, 1, 2
"d:\PZB\Cocos3D\HelloTK3.4.0\bulid\HelloTK\cocos-js\instantiated-9922024b.js", "JavaScript", 0, 1, 0, 0, 0, 1, 2
"d:\PZB\Cocos3D\HelloTK3.4.0\bulid\HelloTK\cocos-js\physics-ammo.js", "JavaScript", 0, 1, 0, 0, 0, 1, 2
"d:\PZB\Cocos3D\HelloTK3.4.0\bulid\HelloTK\cocos-js\physics-framework.js", "JavaScript", 0, 1, 0, 0, 0, 1, 2
"d:\PZB\Cocos3D\HelloTK3.4.0\bulid\HelloTK\cocos-js\tuple-dictionary-5e20c301.js", "JavaScript", 0, 1, 0, 0, 0, 1, 2
"d:\PZB\Cocos3D\HelloTK3.4.0\bulid\HelloTK\cocos-js\wait-for-ammo-instantiation.js", "JavaScript", 0, 1, 0, 0, 0, 1, 2
"d:\PZB\Cocos3D\HelloTK3.4.0\bulid\HelloTK\cocos\2d.js", "JavaScript", 0, 1, 0, 0, 0, 1, 2
"d:\PZB\Cocos3D\HelloTK3.4.0\bulid\HelloTK\cocos\3d.js", "JavaScript", 0, 1, 0, 0, 0, 1, 2
"d:\PZB\Cocos3D\HelloTK3.4.0\bulid\HelloTK\cocos\audio.js", "JavaScript", 0, 1, 0, 0, 0, 1, 2
"d:\PZB\Cocos3D\HelloTK3.4.0\bulid\HelloTK\cocos\base.js", "JavaScript", 0, 1, 0, 0, 0, 1, 2
"d:\PZB\Cocos3D\HelloTK3.4.0\bulid\HelloTK\cocos\camera-component-ec549211.js", "JavaScript", 0, 1, 0, 0, 0, 1, 2
"d:\PZB\Cocos3D\HelloTK3.4.0\bulid\HelloTK\cocos\capsule-1280d817.js", "JavaScript", 0, 1, 0, 0, 0, 1, 2
"d:\PZB\Cocos3D\HelloTK3.4.0\bulid\HelloTK\cocos\create-mesh-9aab53f1.js", "JavaScript", 0, 1, 0, 0, 0, 1, 2
"d:\PZB\Cocos3D\HelloTK3.4.0\bulid\HelloTK\cocos\deprecated-0fa1cf2f.js", "JavaScript", 0, 1, 0, 0, 0, 1, 2
"d:\PZB\Cocos3D\HelloTK3.4.0\bulid\HelloTK\cocos\deprecated-81ea4bff.js", "JavaScript", 0, 1, 0, 0, 0, 1, 2
"d:\PZB\Cocos3D\HelloTK3.4.0\bulid\HelloTK\cocos\deprecated-ddee6a28.js", "JavaScript", 0, 1, 0, 0, 0, 1, 2
"d:\PZB\Cocos3D\HelloTK3.4.0\bulid\HelloTK\cocos\gfx-webgl.js", "JavaScript", 0, 1, 0, 0, 0, 1, 2
"d:\PZB\Cocos3D\HelloTK3.4.0\bulid\HelloTK\cocos\graphics-f8140643.js", "JavaScript", 0, 1, 0, 0, 0, 1, 2
"d:\PZB\Cocos3D\HelloTK3.4.0\bulid\HelloTK\cocos\index-31f38084.js", "JavaScript", 0, 1, 0, 0, 0, 1, 2
"d:\PZB\Cocos3D\HelloTK3.4.0\bulid\HelloTK\cocos\index-60bf8166.js", "JavaScript", 0, 1, 0, 0, 0, 1, 2
"d:\PZB\Cocos3D\HelloTK3.4.0\bulid\HelloTK\cocos\index-da6f70c6.js", "JavaScript", 0, 1, 0, 0, 0, 1, 2
"d:\PZB\Cocos3D\HelloTK3.4.0\bulid\HelloTK\cocos\intersection-2d-5766c37d.js", "JavaScript", 0, 1, 0, 0, 0, 1, 2
"d:\PZB\Cocos3D\HelloTK3.4.0\bulid\HelloTK\cocos\intersection-2d.js", "JavaScript", 0, 1, 0, 0, 0, 1, 2
"d:\PZB\Cocos3D\HelloTK3.4.0\bulid\HelloTK\cocos\json-asset-1a4fee7d.js", "JavaScript", 0, 1, 0, 0, 0, 1, 2
"d:\PZB\Cocos3D\HelloTK3.4.0\bulid\HelloTK\cocos\mesh-c8768986.js", "JavaScript", 0, 1, 0, 0, 0, 1, 2
"d:\PZB\Cocos3D\HelloTK3.4.0\bulid\HelloTK\cocos\mesh-renderer-86d175c0.js", "JavaScript", 0, 1, 0, 0, 0, 1, 2
"d:\PZB\Cocos3D\HelloTK3.4.0\bulid\HelloTK\cocos\particle.js", "JavaScript", 0, 1, 0, 0, 0, 1, 2
"d:\PZB\Cocos3D\HelloTK3.4.0\bulid\HelloTK\cocos\plugin.json", "JSON", 3, 0, 0, 0, 0, 1, 4
"d:\PZB\Cocos3D\HelloTK3.4.0\bulid\HelloTK\cocos\primitive.js", "JavaScript", 0, 1, 0, 0, 0, 1, 2
"d:\PZB\Cocos3D\HelloTK3.4.0\bulid\HelloTK\cocos\profiler.js", "JavaScript", 0, 1, 0, 0, 0, 1, 2
"d:\PZB\Cocos3D\HelloTK3.4.0\bulid\HelloTK\cocos\renderable-2d-f6cb180f.js", "JavaScript", 0, 1, 0, 0, 0, 1, 2
"d:\PZB\Cocos3D\HelloTK3.4.0\bulid\HelloTK\cocos\renderable-component-b5e46bae.js", "JavaScript", 0, 1, 0, 0, 0, 1, 2
"d:\PZB\Cocos3D\HelloTK3.4.0\bulid\HelloTK\cocos\signature.json", "JSON", 1, 0, 0, 0, 0, 1, 2
"d:\PZB\Cocos3D\HelloTK3.4.0\bulid\HelloTK\cocos\skeleton-314b4fa5.js", "JavaScript", 0, 1, 0, 0, 0, 1, 2
"d:\PZB\Cocos3D\HelloTK3.4.0\bulid\HelloTK\cocos\sprite-723e419c.js", "JavaScript", 0, 1, 0, 0, 0, 1, 2
"d:\PZB\Cocos3D\HelloTK3.4.0\bulid\HelloTK\cocos\sprite-frame-1c023836.js", "JavaScript", 0, 1, 0, 0, 0, 1, 2
"d:\PZB\Cocos3D\HelloTK3.4.0\bulid\HelloTK\cocos\terrain-asset-42611908.js", "JavaScript", 0, 1, 0, 0, 0, 1, 2
"d:\PZB\Cocos3D\HelloTK3.4.0\bulid\HelloTK\cocos\terrain.js", "JavaScript", 0, 1, 0, 0, 0, 1, 2
"d:\PZB\Cocos3D\HelloTK3.4.0\bulid\HelloTK\cocos\texture-buffer-pool-32e209c1.js", "JavaScript", 0, 1, 0, 0, 0, 1, 2
"d:\PZB\Cocos3D\HelloTK3.4.0\bulid\HelloTK\cocos\transform-utils-65bf8251.js", "JavaScript", 0, 1, 0, 0, 0, 1, 2
"d:\PZB\Cocos3D\HelloTK3.4.0\bulid\HelloTK\cocos\tween.js", "JavaScript", 0, 1, 0, 0, 0, 1, 2
"d:\PZB\Cocos3D\HelloTK3.4.0\bulid\HelloTK\cocos\ui.js", "JavaScript", 0, 1, 0, 0, 0, 1, 2
"d:\PZB\Cocos3D\HelloTK3.4.0\bulid\HelloTK\cocos\vertex-format-bf491aa3.js", "JavaScript", 0, 1, 0, 0, 0, 1, 2
"d:\PZB\Cocos3D\HelloTK3.4.0\bulid\HelloTK\cocos\video.js", "JavaScript", 0, 1, 0, 0, 0, 1, 2
"d:\PZB\Cocos3D\HelloTK3.4.0\bulid\HelloTK\cocos\view-50c22e7e.js", "JavaScript", 0, 1, 0, 0, 0, 1, 2
"d:\PZB\Cocos3D\HelloTK3.4.0\bulid\HelloTK\cocos\webgl-define-47af0bf2.js", "JavaScript", 0, 1, 0, 0, 0, 1, 2
"d:\PZB\Cocos3D\HelloTK3.4.0\bulid\HelloTK\cocos\webview.js", "JavaScript", 0, 1, 0, 0, 0, 1, 2
"d:\PZB\Cocos3D\HelloTK3.4.0\bulid\HelloTK\first-screen.js", "JavaScript", 0, 241, 0, 0, 0, 20, 261
"d:\PZB\Cocos3D\HelloTK3.4.0\bulid\HelloTK\game.js", "JavaScript", 0, 76, 0, 0, 16, 9, 101
"d:\PZB\Cocos3D\HelloTK3.4.0\bulid\HelloTK\game.json", "JSON", 22, 0, 0, 0, 0, 1, 23
"d:\PZB\Cocos3D\HelloTK3.4.0\bulid\HelloTK\libs\common\cache-manager.js", "JavaScript", 0, 232, 0, 0, 28, 28, 288
"d:\PZB\Cocos3D\HelloTK3.4.0\bulid\HelloTK\libs\common\engine\AssetManager.js", "JavaScript", 0, 431, 0, 0, 6, 64, 501
"d:\PZB\Cocos3D\HelloTK3.4.0\bulid\HelloTK\libs\common\engine\Editbox.js", "JavaScript", 0, 149, 0, 0, 1, 38, 188
"d:\PZB\Cocos3D\HelloTK3.4.0\bulid\HelloTK\libs\common\engine\Game.js", "JavaScript", 0, 59, 0, 0, 1, 13, 73
"d:\PZB\Cocos3D\HelloTK3.4.0\bulid\HelloTK\libs\common\engine\globalAdapter\ContainerStrategy.js", "JavaScript", 0, 15, 0, 0, 1, 5, 21
"d:\PZB\Cocos3D\HelloTK3.4.0\bulid\HelloTK\libs\common\engine\globalAdapter\View.js", "JavaScript", 0, 34, 0, 0, 1, 4, 39
"d:\PZB\Cocos3D\HelloTK3.4.0\bulid\HelloTK\libs\common\engine\globalAdapter\index.js", "JavaScript", 0, 5, 0, 0, 0, 1, 6
"d:\PZB\Cocos3D\HelloTK3.4.0\bulid\HelloTK\libs\common\engine\index.js", "JavaScript", 0, 5, 0, 0, 0, 4, 9
"d:\PZB\Cocos3D\HelloTK3.4.0\bulid\HelloTK\libs\common\engine\misc.js", "JavaScript", 0, 2, 0, 0, 0, 1, 3
"d:\PZB\Cocos3D\HelloTK3.4.0\bulid\HelloTK\libs\common\xmldom\dom-parser.js", "JavaScript", 0, 195, 0, 0, 54, 41, 290
"d:\PZB\Cocos3D\HelloTK3.4.0\bulid\HelloTK\libs\common\xmldom\dom.js", "JavaScript", 0, 1056, 0, 0, 133, 274, 1463
"d:\PZB\Cocos3D\HelloTK3.4.0\bulid\HelloTK\libs\common\xmldom\entities.js", "JavaScript", 0, 244, 0, 0, 0, 1, 245
"d:\PZB\Cocos3D\HelloTK3.4.0\bulid\HelloTK\libs\common\xmldom\sax.js", "JavaScript", 0, 522, 0, 0, 69, 156, 747
"d:\PZB\Cocos3D\HelloTK3.4.0\bulid\HelloTK\libs\wrapper\builtin\Audio.js", "JavaScript", 0, 231, 0, 0, 1, 41, 273
"d:\PZB\Cocos3D\HelloTK3.4.0\bulid\HelloTK\libs\wrapper\builtin\Canvas.js", "JavaScript", 0, 54, 0, 0, 3, 12, 69
"d:\PZB\Cocos3D\HelloTK3.4.0\bulid\HelloTK\libs\wrapper\builtin\Element.js", "JavaScript", 0, 31, 0, 0, 0, 19, 50
"d:\PZB\Cocos3D\HelloTK3.4.0\bulid\HelloTK\libs\wrapper\builtin\Event.js", "JavaScript", 0, 19, 0, 0, 0, 6, 25
"d:\PZB\Cocos3D\HelloTK3.4.0\bulid\HelloTK\libs\wrapper\builtin\EventIniter\MouseEvent.js", "JavaScript", 0, 11, 0, 0, 0, 4, 15
"d:\PZB\Cocos3D\HelloTK3.4.0\bulid\HelloTK\libs\wrapper\builtin\EventIniter\TouchEvent.js", "JavaScript", 0, 34, 0, 0, 0, 8, 42
"d:\PZB\Cocos3D\HelloTK3.4.0\bulid\HelloTK\libs\wrapper\builtin\EventIniter\index.js", "JavaScript", 0, 19, 0, 0, 0, 4, 23
"d:\PZB\Cocos3D\HelloTK3.4.0\bulid\HelloTK\libs\wrapper\builtin\EventTarget.js", "JavaScript", 0, 66, 0, 0, 0, 22, 88
"d:\PZB\Cocos3D\HelloTK3.4.0\bulid\HelloTK\libs\wrapper\builtin\FileReader.js", "JavaScript", 0, 20, 0, 0, 3, 8, 31
"d:\PZB\Cocos3D\HelloTK3.4.0\bulid\HelloTK\libs\wrapper\builtin\HTMLAudioElement.js", "JavaScript", 0, 27, 0, 0, 0, 18, 45
"d:\PZB\Cocos3D\HelloTK3.4.0\bulid\HelloTK\libs\wrapper\builtin\HTMLCanvasElement.js", "JavaScript", 0, 14, 0, 0, 7, 6, 27
"d:\PZB\Cocos3D\HelloTK3.4.0\bulid\HelloTK\libs\wrapper\builtin\HTMLElement.js", "JavaScript", 0, 79, 0, 0, 0, 25, 104
"d:\PZB\Cocos3D\HelloTK3.4.0\bulid\HelloTK\libs\wrapper\builtin\HTMLImageElement.js", "JavaScript", 0, 11, 0, 0, 7, 5, 23
"d:\PZB\Cocos3D\HelloTK3.4.0\bulid\HelloTK\libs\wrapper\builtin\HTMLMediaElement.js", "JavaScript", 0, 48, 0, 0, 0, 21, 69
"d:\PZB\Cocos3D\HelloTK3.4.0\bulid\HelloTK\libs\wrapper\builtin\HTMLVideoElement.js", "JavaScript", 0, 28, 0, 0, 0, 18, 46
"d:\PZB\Cocos3D\HelloTK3.4.0\bulid\HelloTK\libs\wrapper\builtin\Image.js", "JavaScript", 0, 14, 0, 0, 0, 6, 20
"d:\PZB\Cocos3D\HelloTK3.4.0\bulid\HelloTK\libs\wrapper\builtin\ImageBitmap.js", "JavaScript", 0, 11, 0, 0, 0, 5, 16
"d:\PZB\Cocos3D\HelloTK3.4.0\bulid\HelloTK\libs\wrapper\builtin\Node.js", "JavaScript", 0, 56, 0, 0, 4, 24, 84
"d:\PZB\Cocos3D\HelloTK3.4.0\bulid\HelloTK\libs\wrapper\builtin\WebGLRenderingContext.js", "JavaScript", 0, 307, 0, 0, 0, 5, 312
"d:\PZB\Cocos3D\HelloTK3.4.0\bulid\HelloTK\libs\wrapper\builtin\WebSocket.js", "JavaScript", 0, 88, 0, 0, 7, 22, 117
"d:\PZB\Cocos3D\HelloTK3.4.0\bulid\HelloTK\libs\wrapper\builtin\WindowProperties.js", "JavaScript", 0, 33, 0, 0, 0, 3, 36
"d:\PZB\Cocos3D\HelloTK3.4.0\bulid\HelloTK\libs\wrapper\builtin\Worker.js", "JavaScript", 0, 11, 0, 0, 0, 3, 14
"d:\PZB\Cocos3D\HelloTK3.4.0\bulid\HelloTK\libs\wrapper\builtin\XMLHttpRequest.js", "JavaScript", 0, 197, 0, 0, 6, 63, 266
"d:\PZB\Cocos3D\HelloTK3.4.0\bulid\HelloTK\libs\wrapper\builtin\document.js", "JavaScript", 0, 121, 0, 0, 0, 22, 143
"d:\PZB\Cocos3D\HelloTK3.4.0\bulid\HelloTK\libs\wrapper\builtin\index.js", "JavaScript", 0, 55, 0, 0, 0, 23, 78
"d:\PZB\Cocos3D\HelloTK3.4.0\bulid\HelloTK\libs\wrapper\builtin\localStorage.js", "JavaScript", 0, 32, 0, 0, 0, 4, 36
"d:\PZB\Cocos3D\HelloTK3.4.0\bulid\HelloTK\libs\wrapper\builtin\location.js", "JavaScript", 0, 13, 0, 0, 0, 1, 14
"d:\PZB\Cocos3D\HelloTK3.4.0\bulid\HelloTK\libs\wrapper\builtin\navigator.js", "JavaScript", 0, 35, 0, 0, 3, 5, 43
"d:\PZB\Cocos3D\HelloTK3.4.0\bulid\HelloTK\libs\wrapper\builtin\util\index.js", "JavaScript", 0, 6, 0, 0, 0, 2, 8
"d:\PZB\Cocos3D\HelloTK3.4.0\bulid\HelloTK\libs\wrapper\builtin\window.js", "JavaScript", 0, 194, 0, 0, 1, 23, 218
"d:\PZB\Cocos3D\HelloTK3.4.0\bulid\HelloTK\libs\wrapper\engine\VideoPlayer.js", "JavaScript", 0, 369, 0, 0, 24, 69, 462
"d:\PZB\Cocos3D\HelloTK3.4.0\bulid\HelloTK\libs\wrapper\engine\index.js", "JavaScript", 0, 3, 0, 0, 0, 2, 5
"d:\PZB\Cocos3D\HelloTK3.4.0\bulid\HelloTK\libs\wrapper\engine\sprite-frame.js", "JavaScript", 0, 21, 0, 0, 0, 6, 27
"d:\PZB\Cocos3D\HelloTK3.4.0\bulid\HelloTK\libs\wrapper\fs-utils.js", "JavaScript", 0, 214, 0, 0, 24, 5, 243
"d:\PZB\Cocos3D\HelloTK3.4.0\bulid\HelloTK\libs\wrapper\unify.js", "JavaScript", 0, 84, 0, 0, 2, 23, 109
"d:\PZB\Cocos3D\HelloTK3.4.0\bulid\HelloTK\libs\wrapper\utils.js", "JavaScript", 0, 10, 0, 0, 6, 1, 17
"d:\PZB\Cocos3D\HelloTK3.4.0\bulid\HelloTK\project.config.json", "JSON", 59, 0, 0, 0, 0, 0, 59
"d:\PZB\Cocos3D\HelloTK3.4.0\bulid\HelloTK\src\bundle-scripts\Animation\index.1cb29.js", "JavaScript", 0, 17, 0, 0, 1, 3, 21
"d:\PZB\Cocos3D\HelloTK3.4.0\bulid\HelloTK\src\bundle-scripts\Material\index.a2ebe.js", "JavaScript", 0, 17, 0, 0, 1, 3, 21
"d:\PZB\Cocos3D\HelloTK3.4.0\bulid\HelloTK\src\bundle-scripts\Model\index.8cd1b.js", "JavaScript", 0, 17, 0, 0, 1, 3, 21
"d:\PZB\Cocos3D\HelloTK3.4.0\bulid\HelloTK\src\bundle-scripts\Prefab\index.867ef.js", "JavaScript", 0, 17, 0, 0, 1, 3, 21
"d:\PZB\Cocos3D\HelloTK3.4.0\bulid\HelloTK\src\bundle-scripts\Texture\index.5ae95.js", "JavaScript", 0, 17, 0, 0, 1, 3, 21
"d:\PZB\Cocos3D\HelloTK3.4.0\bulid\HelloTK\src\bundle-scripts\resources\index.af382.js", "JavaScript", 0, 17, 0, 0, 1, 3, 21
"d:\PZB\Cocos3D\HelloTK3.4.0\bulid\HelloTK\src\chunks\bundle.6150a.js", "JavaScript", 0, 3, 0, 0, 1, 1, 5
"d:\PZB\Cocos3D\HelloTK3.4.0\bulid\HelloTK\src\import-map.8d466.js", "JavaScript", 0, 25, 0, 0, 0, 1, 26
"d:\PZB\Cocos3D\HelloTK3.4.0\bulid\HelloTK\src\polyfills.bundle.43263.js", "JavaScript", 0, 1, 0, 0, 0, 1, 2
"d:\PZB\Cocos3D\HelloTK3.4.0\bulid\HelloTK\src\settings.ee20e.json", "JSON", 1, 0, 0, 0, 0, 0, 1
"d:\PZB\Cocos3D\HelloTK3.4.0\bulid\HelloTK\src\system.bundle.75084.js", "JavaScript", 0, 1, 0, 0, 1, 1, 3
"d:\PZB\Cocos3D\HelloTK3.4.0\bulid\HelloTK\subpackages\main\config.c7282.json", "JSON", 1, 0, 0, 0, 0, 0, 1
"d:\PZB\Cocos3D\HelloTK3.4.0\bulid\HelloTK\subpackages\main\game.js", "JavaScript", 0, 17, 0, 0, 1, 3, 21
"d:\PZB\Cocos3D\HelloTK3.4.0\bulid\HelloTK\subpackages\main\import\03\03927e900.b88a4.json", "JSON", 1, 0, 0, 0, 0, 1, 2
"d:\PZB\Cocos3D\HelloTK3.4.0\bulid\HelloTK\subpackages\main\import\04\043c5e3c3.40923.json", "JSON", 1, 0, 0, 0, 0, 1, 2
"d:\PZB\Cocos3D\HelloTK3.4.0\bulid\HelloTK\subpackages\main\import\07\07a44a026.5b2be.json", "JSON", 1, 0, 0, 0, 0, 1, 2
"d:\PZB\Cocos3D\HelloTK3.4.0\bulid\HelloTK\subpackages\main\import\07\07cb71310.39f09.json", "JSON", 1, 0, 0, 0, 0, 1, 2
"d:\PZB\Cocos3D\HelloTK3.4.0\bulid\HelloTK\subpackages\main\import\09\09ba66590.f7381.json", "JSON", 1, 0, 0, 0, 0, 1, 2
"d:\PZB\Cocos3D\HelloTK3.4.0\bulid\HelloTK\subpackages\main\import\0b\0b4ad8b20.11e3a.json", "JSON", 1, 0, 0, 0, 0, 1, 2
"d:\PZB\Cocos3D\HelloTK3.4.0\bulid\HelloTK\subpackages\main\import\0b\0be2ae0d-cd18-4ba5-a4e5-6385696065f1.ce8a5.json", "JSON", 1, 0, 0, 0, 0, 1, 2
"d:\PZB\Cocos3D\HelloTK3.4.0\bulid\HelloTK\subpackages\main\import\0c\0ca97856f.1ff7e.json", "JSON", 1, 0, 0, 0, 0, 1, 2
"d:\PZB\Cocos3D\HelloTK3.4.0\bulid\HelloTK\subpackages\main\import\0d\0d8bfd88d.1b0d2.json", "JSON", 1, 0, 0, 0, 0, 1, 2
"d:\PZB\Cocos3D\HelloTK3.4.0\bulid\HelloTK\subpackages\main\import\0d\0dee15d70.2e324.json", "JSON", 1, 0, 0, 0, 0, 1, 2
"d:\PZB\Cocos3D\HelloTK3.4.0\bulid\HelloTK\subpackages\main\import\0e\0e7a94718.40462.json", "JSON", 1, 0, 0, 0, 0, 1, 2
"d:\PZB\Cocos3D\HelloTK3.4.0\bulid\HelloTK\subpackages\main\import\62\624bb6a2-a019-4ed5-add6-0e2d1c14fab6@f9941.1895e.json", "JSON", 1, 0, 0, 0, 0, 1, 2
"d:\PZB\Cocos3D\HelloTK3.4.0\bulid\HelloTK\subpackages\main\import\eb\eba3285f-aefe-49cf-bd61-b81b269fdea2.e1d05.json", "JSON", 1, 0, 0, 0, 0, 1, 2
"d:\PZB\Cocos3D\HelloTK3.4.0\package.json", "JSON", 9, 0, 0, 0, 0, 1, 10
"d:\PZB\Cocos3D\HelloTK3.4.0\settings\v2\packages\builder.json", "JSON", 3, 0, 0, 0, 0, 1, 4
"d:\PZB\Cocos3D\HelloTK3.4.0\settings\v2\packages\cocos-service.json", "JSON", 53, 0, 0, 0, 0, 1, 54
"d:\PZB\Cocos3D\HelloTK3.4.0\settings\v2\packages\device.json", "JSON", 3, 0, 0, 0, 0, 1, 4
"d:\PZB\Cocos3D\HelloTK3.4.0\settings\v2\packages\engine.json", "JSON", 115, 0, 0, 0, 0, 1, 116
"d:\PZB\Cocos3D\HelloTK3.4.0\settings\v2\packages\program.json", "JSON", 3, 0, 0, 0, 0, 1, 4
"d:\PZB\Cocos3D\HelloTK3.4.0\settings\v2\packages\project.json", "JSON", 10, 0, 0, 0, 0, 1, 11
"d:\PZB\Cocos3D\HelloTK3.4.0\tsconfig.json", "JSON with Comments", 0, 0, 6, 0, 2, 2, 10
"Total", "-", 1441, 6381, 6, 4956, 750, 2083, 15617